11111111111111111
10000000100000001
13101110101110131
10000010101000001
11101000000010111
22101111011110122
22101000000010122
11100011211000111
40001012521010000
11101011111010111
22100000000000122
11101011111010111
10001001110010001
10101100000110101
13100001110000131
10001100000110001
11111111111111111
